"a" = (/turf/open/floor/partyhard/steel{icon_state = "f-1"},/area/shuttle/partyhard)
"b" = (/obj/machinery/light{icon_state = "tube"; dir = 1},/turf/open/floor/partyhard/steel,/area/shuttle/partyhard)
"c" = (/turf/open/floor/partyhard/steel{icon_state = "f-2"},/area/shuttle/partyhard)
"d" = (/turf/open/floor/partyhard/steel{icon_state = "g-1"},/area/shuttle/partyhard)
"e" = (/turf/open/floor/partyhard/steel{icon_state = "x-1"},/area/shuttle/partyhard)
"f" = (/turf/open/floor/partyhard/steel{icon_state = "f-3"},/area/shuttle/partyhard)
"g" = (/turf/open/floor/partyhard/steel{icon_state = "f-4"},/area/shuttle/partyhard)
"h" = (/obj/docking_port/mobile/elevator{height = 3; id = "partyhard_elevator"; name = "partyhard elevator"; dwidth = 1; width = 3},/turf/open/floor/partyhard/steel,/area/shuttle/partyhard)

(1,1,1) = {"
abc
ded
fhg
"}
